1111/1234
2222/2345
5555/5678
3333/3456
4444/4567
